5 5
S # 0 0 0
0 0 0 0 0
# 0 # 0 0
0 # 0 0 0
0 0 0 # F